1111111111111111111111111111111111111111111111111
10000000000X00C00000C000000000000000000000000X001
1010010100100000101001000000010100001001010010001
10100100101010100010010000X0010100001001001010101
100000000C00C000X000000000000001C0000000000C00C01
1E000000000X00C00000C000000000000000000000000X001
1010010100100000101001000000010100001001010010001
10100100101010100010010000X0010101101001001010101
1P0000000C00C000X000000000000001C1100000000C00C01
1111111111111111111111111111111111111111111111111