1111111111111111111111111111111111
1CE000000000000C00000C100000000001
1110010100100000101001000000010101
111001001010101001P001000000010101
1000000C00C0000000100000000000C101
1111111111111111111111111111111111